﻿....###############################....
.......................................
.......................................
.......................................
.......................................
.......................................
..........######.....######............
..........#...............#............
..........#...............#............
..........#...............#............
..........#...............#............
..........#...............#............
..........#################............
.....##############################....
.......................................
.......................................
.......................................
.......................................
.......................................
.......................................
.......................................
.......................................
.......................................
.......................................
.......................................
.......................................
.......................................
.......................................
.......................................
.....##############################....
.......................................
.......................................
.......................................
.......................................
.......................................
.......................................
.......................................
.......................................
.......................................
.......................................